1111111111111111111111111111111111111111111111111111111111111111111111111111111
1P10000000001C0000000000000000000010001000100000000000000000001000000000001C001
1011111110101111111110111011111110101010101011111111111110111110101111111011101
1000000000101000000010001010000000101000100010000000000010000000101000001000001
1111111111101011111011111011111111101111111110111111111011111111101011111111101
1000000010001000101010001000000000101010000000100000001000000000001010000000001
1111101010111010101010101111101110101010111111101111101111111111111010111111111
1000001010001010100000100000101000101010000010101000000010000000000010000010001
1011111011101110111111111110111010101011111010101011111110111111111011111010101
1000100000100010100000000010100010101000001010001000000010000010000010001010101
1110111111111010101111111010101111101010111010111111111011111010111010101010101
1000100010000010101000000010001000001010100010100000100000001010001010100010101
1010101010111110101011111111111011111110101111101110101111111011101110111110101
1010101010100010001000000000001000000010100000000010100000001010100000100000101
1010101010101110111111111111101111111010111111111110101111101010111111111110111
1010101010100010100000100000100000000000000010000000101000001010001000000010001
1011101010111010111010111010111111111111111110111111111011111010101111101011101
1000101010001010100010000010100000000000000000100010001010000010101000001000001
1110101011101010101110111110101111111110111111101010101010111110101011111111101
1000101000001000101000100010100010000000100000001000101000000000101000001000001
1011101111111011101111101011111011111111101111111111101111111111101111101111101
1000001000100000001000001000001000100000001000000000100000000010101000100000101
1011111011101111111011111111101110101111111011111110111011111010101010111110101
1000100000001000000010000010100000100010100010000010001000100010001010000000101
1110101111111011111010111010111110111010101110111111101111101110111011101111111
1C10100010000010001010101010000000100000100010100000100010001010100010001000001
1010111010111110101110101011111111101111111010101110111010111010111011111011101
1010001010000010100010101000000000000010000010001010100010101000100010001010001
1011101011111010111010101111111111111010111110111010101110101011101110101010111
1010001010000010101000000010000000001010100000000010000000101010000000100010001
1010111010111110101111111010111111101010111111111111111111101011101111111111101
10101C1010000000000010001010001000101010000000100000000010001000100010000000001
1010101011111111111110101111101011101111111010101111111011101110111110111111101
1010100010000000000000100010001000100000001010001000100010000010000010000000101
1010111110111111111111111010111010111111101110111110101110111111111011111110101
1010000010000000100000001000100010000000100010000000101000100000001000000000101
1011111011111110101011111111101111111110111010111111101110101111101111111111101
1000001010000000101010000000101000001000001010100000100010001000000000000010001
1010111010111111101110101111101111101011111011101110111010111011111111111110111
10100000001000000000001000000000000010000000000010000000100010000000000000000E1
1111111111111111111111111111111111111111111111111111111111111111111111111111111