1111111111111111111111111111111111111111111111111111111111111111111111111111111
1001000001000010000000101C1000101000000100100000010010100100010010001C001001001
10000010010010100101000010100010100010010010001C0100001001010100100010001000001
1101111111001010010100100011100000011000001011110101101011010100001111011001001
1000101001101111011111111110001000001001000000100000100000010100100000001111101
10001010010000100100001000111111011111111111111111111111111111101111100C1001001
1110001011101110010C10000010000000000101001000100000010000010100000010C01000001
100010100100101011101110111000100C100000001000101000010010000110111111111111101
1011111000000C100100101000101110111000C10110000011101100100C01001001000C1000001
10000000111011100100001000100010001110110000111010000111111011001001001C0001001
1001000001000010011111101111101111100001001000001000010010100101100000101111011
111111011100101011000100001000000010000110111111111011001010010010111111100C001
1000000001001000000000000010C10010100101000000001000010110101100100010001101111
1111111111111011111111111111011110111101000100101001010000100101100000001000001
1001001001000001001000000010010010100101110111111111011010001100000000001001001
100000100000010100100010001101000010010100000C001000C10000000111111101111111111
110110000111010110111011101000001110C001000010001111011111011100000100000100101
1001001001000001C00000100010010000100101111011101001010000010100100100100000101
111111101111101100101111111101111111111100001000100001001000010010C110101110001
1001C00001000001001001000010001010000001011111111001011111101101110000100100101
1001000101101111101001001010001000010001001010001111010010000100100110100100101
1101000001000001001001111011101010111011001000001000010010010100000100101110101
1001110111110111C01000000010000010010001000010001001010111011100100100100000101
1001000001000101101001001011111111011111111111111111110000000111111111110111111
10111011110000010010C1001000001000001000101000000100010010000100100100100000101
1000001001011101001111111010001001001000001000100100011111101100000100000010001
100100000100010000100000C010100001011101111000100000010010000110111111111111011
1111111111111111111110111110001001001000001111110101110000010100100100000010001
1001001000100010100010100011101111111001000001000100010110111100100100101010001
1001000000100010100000000010C00000101001001001000100010010000101110100100010111
1011111101100010101111111110010100101011111000000100011110111100100111110110001
1C010001C0001010100000000010000100001C00101111111111010000010100000100100011011
10010001001000101000010010111011110110000010010010010100010101111101001P0010001
1101010001100000111011011010000100001011101001000001000001010100100100000010111
1001000100100010100001001010111111100000101100001000010111110100100001101000001
1001101111111110100101001010000C00001000101001001001010000000000000100000010001
1000001001001010100101001011111111111111111111111111011111111101111111111111111
100100100100001011111101111001010010000000000010010000100C010100E10000001000001
110100001110101010000000001C010100100010010010100101000010000100000001001001001
1001001000001010000100100010000000000010010010000001001010010100010001000001001
1111111111111111111111111111111111111111111111111111111111111111111111111111111